- Black side mirrors with integrated turn indicators | Black side mirrors with integrated turn indicators, electrically adjustable | Exterior
- Rear spoiler | Rear spoiler | Exterior
- Shark fin antenna | Shark fin antenna in black | Exterior
- LED front headlights | LED front headlights | Lighting
- LED daytime running lights | LED daytime running lights | Lighting
- Rear LED fog light | Rear LED fog light | Lighting
- Automatic windshield wipers with rain sensor | Automatic windshield wipers with rain sensor | Exterior
- Turn indicator with triple flash function | Turn indicator with triple flash function | Exterior
- "Follow Me Home" lighting feature | "Follow Me Home" lighting feature | Lighting
- Intelligent automatic front headlights | Intelligent automatic front headlights | Lighting
- 17" steel wheels | 17" steel wheels, Sakura design | Exterior
- Satin Chrome finish on interior side door handles | Satin Chrome finish on interior side door handles | Interior
- Front side door pockets with drink holders | Front side door pockets with drink holders | Interior
- Driver and passenger sun visors with mirrors | Driver and passenger sun visors with mirrors | Interior
- Cabin lighting | Cabin lighting in both front and rear | Interior
- Luggage compartment lighting | Luggage compartment lighting | Interior
- Monoform sport-style seats | Monoform sport-style seats with black fabric upholstery | Interior
- Heated front seats | Heated front seats | Interior
- Driver's seat with adjustable height | Driver's seat with adjustable height | Interior
- 60:40 split-folding rear seat | 60:40 split-folding rear seat | Interior
- Two cup holders | Two cup holders | Interior
- Front armrest | Front armrest | Interior
- Three adjustable rear headrests | Three adjustable rear headrests | Interior
- 4 speakers | 4 speakers | Interior
- Bluetooth connectivity | Bluetooth, USB, AUX, and 12V connectivity | Technology
- USB connectivity | Bluetooth, USB, AUX, and 12V connectivity | Technology
- AUX connectivity | Bluetooth, USB, AUX, and 12V connectivity | Technology
- 12V connectivity | Bluetooth, USB, AUX, and 12V connectivity | Technology
- Rear USB port | Rear USB port | Technology
- 7" color Advanced Driver Assistance Display (ADAD) | 7" color Advanced Driver Assistance Display (ADAD) in the instrument panel | Technology
- 12.3" touchscreen | 12.3" touchscreen | Technology
- Wireless Apple Car Play and Android Auto | Wireless Apple Car Play and Android Auto | Technology
- Stop/Start system | Stop/Start system | Technology
- e-Pedal Step | e-Pedal Step (available only for hybrid version) | Technology
- Electric driving mode switch | Electric driving mode switch (available only for hybrid version) | Technology
- Cruise control with speed limiter | Cruise control with speed limiter | Technology
- Electronic parking brake with automatic hold function | Electronic parking brake with automatic hold function | Technology
- Telescopic steering column control | Telescopic steering column control | Interior
- Multifunction steering wheel | Multifunction steering wheel (audio, phone, cruise control, speed limiter, etc.) | Interior
- Voice recognition switch on the steering wheel | Voice recognition switch on the steering wheel | Technology
- Front and rear power windows with one-touch function for the driver | Front and rear power windows with one-touch function for the driver | Interior
- Rearview camera | Rearview camera | Technology
- Paddle shifters on the steering wheel for automatic transmission vehicles | Paddle shifters on the steering wheel for automatic transmission vehicles | Transmission
- Outside air temperature sensor | Outside air temperature sensor | Technology
- Automatic air conditioning system | Automatic air conditioning system | Interior
- e-Call emergency and breakdown call system | e-Call emergency and breakdown call system | Safety
- Intelligent emergency braking system with pedestrian and cyclist detection | Intelligent emergency braking system with pedestrian and cyclist detection | Safety
- Intelligent lane departure prevention system | Intelligent lane departure prevention system | Safety
- Traffic sign recognition system | Traffic sign recognition system | Safety
- Automatic emergency signal and stop signal | Automatic emergency signal and stop signal | Safety
- Driver and passenger airbags | Driver and passenger airbags, side and curtain airbags | Safety
- Side and curtain airbags | Driver and passenger airbags, side and curtain airbags | Safety
- Height-adjustable seat belts | Height-adjustable seat belts | Safety
- Driver/passenger and rear seat belt usage warning | Driver/passenger and rear seat belt usage warning | Safety
- ISOFIX child seat anchorage points | ISOFIX child seat anchorage points (rear) with top tether | Safety
- Tire Pressure Monitoring System (TPMS) | Tire Pressure Monitoring System (TPMS) | Safety
- ABS with EBD and brake assist | ABS with EBD and brake assist | Safety
- Intelligent ride control | Intelligent ride control | Safety
- Intelligent traction control | Intelligent traction control | Safety
- Active traction control system | Active traction control system | Safety
- Body stability system | Body stability system | Safety
- Hill start assist | Hill start assist | Safety
- Tire repair kit | Tire repair kit | Safety
- Factory-installed alarm system | Factory-installed alarm system | Safety
- Moving object detection system | Moving object detection system | Safety
- Intelligent driver fatigue alert | Intelligent driver fatigue alert | Safety
- Three rear three-point seat belts with load limiter and pretensioner | Three rear three-point seat belts with load limiter and pretensioner | Safety
- Intelligent driver assistance systems | Intelligent driver assistance systems | Technology
- Multifunctional steering wheel controls | Multifunctional steering wheel controls | Technology
- Voice recognition | Voice recognition | Technology
- Wireless connectivity for smartphones | Wireless connectivity for smartphones | Technology
- Advanced driver assistance display | Advanced driver assistance display | Technology
- New vehicle warranty | New vehicle warranty | Other
- Anti-corrosion perforation warranty | Anti-corrosion perforation warranty | Other
- Paint warranty | Paint warranty | Other
- Nissan Assistance and Technical Support Service for 3 years | Nissan Assistance and Technical Support Service for 3 years | Other